a=un
able=capaz
about=sobre
above=encima
accept=aceptar
according=según
account=cuenta
across=atravesar
act=actuar
action=acción
activity=actividad
actually=en-realidad
add=agregar
address=dirección
administration=administración
admit=admitir
adult=adulto
affect=afectar
after=después
again=de-nuevo
against=contra
age=edad
agency=agencia
agent=agente
ago=hace
agree=estar-de-acuerdo
agreement=acuerdo
ahead=adelante
air=aire
all=todo
allow=permitir
almost=casi
alone=solo
along=junto-a
already=ya
also=también
although=aunque
always=siempre
American=americano/a
among=entre
amount=cantidad
analysis=análisis
and=y
animal=animal
another=otro/a
answer=responder
any=cualquier
anyone=cualquiera
anything=cualquier-cosa
appear=aparecer
apply=aplicar
approach=aproximación
area=área
argue=argumentar
arm=brazo
around=alrededor
arrive=llegar
art=arte
article=artículo
artist=artista
as=como
ask=pedir
assume=suponer
at=en
attack=ataque
attention=atención
attorney=abogado/a
audience=audiencia
author=autor/a
authority=autoridad
available=disponible
avoid=evitar
away=lejos
baby=bebé
back=atrás
bad=mal
bag=bolsa
ball=pelota
bank=banco
bar=bar
base=base
be=ser
beat=ganar
beautiful=hermoso/a
because=porque
become=convertirse
bed=cama
before=antes-de
begin=empezar
behavior=comportamiento
behind=detrás
believe=creer
benefit=beneficio
best=mejor
better=mejor
between=entre
beyond=más-allá
big=grande
bill=proyecto
billion=mil-millones
bit=poco
black=negro/a
blood=sangre
blue=azul
board=tablero
body=cuerpo
book=libro
born=nacido/a
boy=niño
branch=rama
break=romper
bring=traer
brother=hermano
budget=presupuesto
build=construir
building=edificio
business=empresa
but=pero
buy=comprar
by=por
call=llamar
camera=cámara
campaign=campaña
can=poder
cancer=cáncer
candidate=candidato/a
capital=capital
car=coche
card=tarjeta
care=cuidado
career=carrera
carry=cargar
case=causa
catch=atrapar
cause=causa
cell=célula
center=centro
central=central
century=siglo
certain=cierto/a
certainly=ciertamente
chair=silla
challenge=desafío
chance=oportunidad
change=cambio
character=personaje
charge=cargo
check=verificar
child=niño/a
choice=elección
choose=elegir
church=iglesia
citizen=ciudadano/a
city=ciudad
civil=civil
claim=reclamar
class=clase
clear=claro/a
clearly=claramente
close=cerrar
coach=entrenador/a
cold=frio/a
collection=colección
college=colegio
color=color
come=venir
commercial=comercial
common=común
community=comunidad
company=compañía
compare=comparar
computer=ordenador
concern=preocupación
condition=condición
conference=conferencia
Congress=Congreso
consider=considerar
consumer=consumidor/a
contain=contener
continue=continuar
control=control
cost=costo
could=podría
country=país
couple=pareja
course=curso
court=tribunal
cover=cubrir
create=crear
crime=delito
criminal=criminal
crisis=crisis
critical=crítico/a
culture=cultura
cup=taza
current=actual
customer=cliente
cut=cortar
dark=oscuro/a
data=datos
daughter=hija
day=día
dead=muerto/a
deal=tratar
death=muerte
debate=debate
decade=década
December=diciembre
decide=decidir
decision=decisión
deep=profundo/a
defense=defensa
degree=grado
deliver=entregar
demand=demanda
democratic=democrático/a
deny=denegar
department=departamento
depend=depender
describe=describir
design=diseñar
despite=a-pesar-de
detail=detalle
determine=determinar
develop=desarrollar
development=desarrollo
die=morir
difference=diferencia
different=diferente
difficult=difícil
dinner=cena
direction=dirección
director=director/a
discover=descubrir
discuss=discutir
discussion=discusión
disease=enfermedad
doctor=doctor/a
dog=perro
door=puerta
down=abajo
draw=dibujar
dream=sueño
drive=conducir
drop=dejar-caer